2 13 31
###############################
#p                            #
# # # # #*# # #*# # # # # #*# #
#      1            2         #
# # # # # # # # #b#1# # # # #*#
#      3               4      #
# # #*# # # # # #*#*#*#*# # # #
#             5               #
# # # #2#*# # # # # #3#*# #*# #
#                             #
# # # # # # #3# #4#*# # # # #*#
#       5              3      #
###############################